PHASE 2: Vocabulary Matching Results
======================================================================

Best mapping: o → e
Total matches: 4,006
Unique matches: 346

Matched words (Voynich → Middle English):
----------------------------------------------------------------------
tochol               → techel
chokor               → cheker
sheedo               → sheede
techol               → techel
deedes               → deedes
tochon               → techen
rotcho               → retche
chekor               → cheker
chees                → chees
chold                → cheld
daiis                → daiis
olees                → elees
cheef                → cheef
olcho                → elche
shoet                → sheet
chete                → chete
sheep                → sheep
polor                → peler
sheet                → sheet
taros                → tares
cholo                → chele
orcho                → erche
choly                → chely
shedo                → shede
chair                → chair
schor                → scher
cheop                → cheep
oldor                → elder
cheok                → cheek
chopo                → chepe
lotos                → letes
aroro                → arere
chese                → chese
choro                → chere
shoro                → shere
oroly                → erely
solor                → seler
choek                → cheek
dario                → darie
cheos                → chees
arody                → aredy
schar                → schar
sheot                → sheet
oscho                → esche
cheek                → cheek
choto                → chete
cheer                → cheer
choko                → cheke
schol                → schel
shoto                → shete
ycham                → ycham
alain                → alain
scheo                → schee
toror                → terer
dalos                → dales
choor                → cheer
porol                → perel
cheor                → cheer
lodar                → ledar
ytaly                → ytaly
chess                → chess
chain                → chain
alos                 → ales
shal                 → shal
salo                 → sale
aith                 → aith
ycho                 → yche
dolo                 → dele
tary                 → tary
ally                 → ally
arod                 → ared
ofor                 → efer
aloy                 → aley
taim                 → taim
axor                 → axer
otes                 → etes
fold                 → feld
sair                 → sair
chop                 → chep
chap                 → chap
odor                 → eder
chon                 → chen
lody                 → ledy
ocho                 → eche
sary                 → sary
ysai                 → ysai
teos                 → tees
seor                 → seer
shot                 → shet
doly                 → dely
yoar                 → year
dalo                 → dale
rody                 → redy
chot                 → chet
dary                 → dary
chan                 → chan
chep                 → chep
alom                 → alem
chet                 → chet
aman                 → aman
chof                 → chef
otas                 → etas
shoo                 → shee
chal                 → chal
aram                 → aram
sham                 → sham
told                 → teld
ofol                 → efel
shep                 → shep
teor                 → teer
toly                 → tely
tedo                 → tede
olch                 → elch
chod                 → ched
chos                 → ches
loly                 → lely
rain                 → rain
chek                 → chek
kodo                 → kede
oaro                 → eare
fora                 → fera
sees                 → sees
dais                 → dais
chym                 → chym
rais                 → rais
shol                 → shel
lair                 → lair
soin                 → sein
doky                 → deky
otos                 → etes
deol                 → deel
otys                 → etys
adar                 → adar
adam                 → adam
alys                 → alys
soir                 → seir
tear                 → tear
sheo                 → shee
foar                 → fear
sain                 → sain
chok                 → chek
ydor                 → yder
cher                 → cher
shed                 → shed
chas                 → chas
olam                 → elam
soes                 → sees
shee                 → shee
doar                 → dear
olan                 → elan
doef                 → deef
daro                 → dare
dyor                 → dyer
eese                 → eese
tees                 → tees
olda                 → elda
defo                 → defe
soly                 → sely
chor                 → cher
char                 → char
alor                 → aler
ched                 → ched
odan                 → edan
stol                 → stel
olko                 → elke
chef                 → chef
olos                 → eles
shod                 → shed
damo                 → dame
sail                 → sail
toar                 → tear
cham                 → cham
pair                 → pair
ches                 → ches
sols                 → sels
oran                 → eran
doal                 → deal
somy                 → semy
del                  → del
ola                  → ela
far                  → far
for                  → fer
dys                  → dys
rol                  → rel
asa                  → asa
tan                  → tan
oir                  → eir
dol                  → del
osy                  → esy
lom                  → lem
kan                  → kan
rad                  → rad
amy                  → amy
eem                  → eem
oto                  → ete
dom                  → dem
ram                  → ram
oko                  → eke
ker                  → ker
koy                  → key
oam                  → eam
fam                  → fam
dos                  → des
oty                  → ety
sar                  → sar
sos                  → ses
yol                  → yel
sha                  → sha
lai                  → lai
tam                  → tam
dor                  → der
nol                  → nel
pom                  → pem
ota                  → eta
oar                  → ear
tor                  → ter
ral                  → ral
ote                  → ete
ted                  → ted
tai                  → tai
har                  → har
lar                  → lar
ded                  → ded
tol                  → tel
alo                  → ale
day                  → day
tas                  → tas
dyd                  → dyd
kas                  → kas
ais                  → ais
dan                  → dan
teo                  → tee
key                  → key
toy                  → tey
any                  → any
sam                  → sam
sai                  → sai
sok                  → sek
aro                  → are
she                  → she
por                  → per
lam                  → lam
tos                  → tes
das                  → das
org                  → erg
dai                  → dai
san                  → san
par                  → par
old                  → eld
hea                  → hea
kyd                  → kyd
oro                  → ere
fol                  → fel
dar                  → dar
kar                  → kar
oal                  → eal
als                  → als
oor                  → eer
edo                  → ede
sor                  → ser
ain                  → ain
oke                  → eke
tom                  → tem
pho                  → phe
opy                  → epy
oin                  → ein
hor                  → her
res                  → res
yor                  → yer
ras                  → ras
pol                  → pel
yey                  → yey
ske                  → ske
tar                  → tar
ols                  → els
ald                  → ald
kod                  → ked
hey                  → hey
las                  → las
lor                  → ler
een                  → een
chr                  → chr
air                  → air
are                  → are
llo                  → lle
tal                  → tal
aim                  → aim
sch                  → sch
hol                  → hel
oly                  → ely
dam                  → dam
soe                  → see
ror                  → rer
ees                  → ees
err                  → err
ldo                  → lde
sho                  → she
ked                  → ked
kam                  → kam
aly                  → aly
eas                  → eas
soy                  → sey
led                  → led
mol                  → mel
tey                  → tey
ary                  → ary
oho                  → ehe
pal                  → pal
doi                  → dei
cho                  → che
olm                  → elm
rod                  → red
fos                  → fes
olo                  → ele
dod                  → ded
les                  → les
los                  → les
che                  → che
ety                  → ety
ron                  → ren
eor                  → eer
lol                  → lel
soi                  → sei
ses                  → ses
tod                  → ted
cha                  → cha
nal                  → nal
loy                  → ley
lod                  → led
sol                  → sel
yto                  → yte
dym                  → dym
oss                  → ess
mar                  → mar
kos                  → kes
oll                  → ell
dey                  → dey
doe                  → dee
ora                  → era
rom                  → rem
xal                  → xal
ear                  → ear
ors                  → ers
kor                  → ker
ara                  → ara
sal                  → sal
